000000000000000000000000000000000000000000000000
000000000000000000000000000000000000000000000000
111111111111111111111111111111111111111111111111
111111111111111111111111111111111111111111111111
110000000000001111000000000000111100000000000011
110000000000001111000000000000111100000000000011
110000000000001111000000000000111100000000000011
110000000000001111000000000000111100000000000011
110000000000001111000000000000111100000000000011
110000000000001111000000000000111100000000000011
110000000000001111000000000000111100000000000011
110000000000001111000000000000111100000000000011
110000000000001111000000000000111100000000000011
110022000000001111003300000000111100440000000011
111111111111111111111111111111111111111111111111
111111111111111111111111111111111111111111111111
111111111111111111111111111111111111111111111111
111111111111111111111111111111111111111111111111
111111111111111111111111111111111111111111111111
111111111111111111111111111111111111111111111111
111111111111111111111111111111111111111111111111
000000000011111111111111111100000000000000000000
000000000011111111111111111100000000000000000000
000000000000000000111111000000000000000000000000
000000011111111111111111111000000000000000000000
000000011111111111111111111000000000000000000000
000000000000000000000000000000000000000000000000
